1111111111111111111111111111111111
1E0C00000000000C10000C0000000000P1
101C010100100000101001000000010101
1C10010010101010101001000000010101
100C00000C00C0001000000000000000C1
1111111111111111111111111111111111
